0 388 0
984 388 0
840 348 1
880 348 1
920 348 1
960 348 1
1040 348 1
1080 348 1
1120 348 1
1000 348 1
1160 348 1
1240 348 1
1280 348 1
1200 348 1
880 308 1
920 308 1
920 268 1
960 268 1
960 308 1
1000 308 1
1000 268 1
1040 268 1
1040 308 1
1080 308 1
1080 268 1
1120 268 1
1120 308 1
1160 308 1
1160 268 1
1200 268 1
1200 308 1
1240 308 1
960 228 1
1000 228 1
1040 228 1
1080 228 1
1120 228 1
1120 188 1
1040 188 1
1000 188 1
1040 148 1
1080 188 1
1080 148 1
1080 108 1
1120 68 1
1120 108 1
1120 148 1
1160 148 1
1160 108 1
1160 28 1
1200 68 1
1160 68 1
1200 108 1
1200 148 1
1160 188 1
1200 188 1
1160 228 1
1200 228 1
1240 108 1
1240 148 1
1240 188 1
1240 228 1
1240 268 1
1280 268 1
1280 188 1
1280 148 1
1280 228 1
1280 308 1
1320 308 1
1320 348 1
1320 188 1
1320 228 1
1320 268 1
1360 228 1
1360 268 1
1360 308 1
1360 348 1
1400 348 1
1400 308 1
1400 268 1
1440 308 1
1440 348 1
1480 348 1
